Gene-specific RT primers
Primer Name	Sequence
RT_Amplicon_1	tttttctttgaggtttagg
RT_Amplicon_2	GCAAGCAGGCATCGCCATG
RT_Amplicon_3	GGGCATCCTTCAGCCCCTT
RT_Amplicon_4	TCCGAGCCGGGATGACATC
RT_Amplicon_5	TAATGTTGGGATTGATGCC
RT_Amplicon_6	TACATTGCAGTCGATCACG
RT_Amplicon_7	ATGTGGCGATGTACTTCGT
RT_Amplicon_8	ATGATGTTGAGAAGGATGG
RT_Amplicon_9	TTTTGACAAGAGATGAAGG
RT_Amplicon_10	ATGGACCTCAATACGTCTG
RT_Amplicon_11	ATATGGTGCTCTCGCTCAG
RT_Amplicon_12	ATCCATACTTGGATCTTGC
RT_Amplicon_13	TTTCACATAGCATGTGATG
RT_Amplicon_14	TATGTGTGCATAGAAAAGG
RT_Amplicon_15	aaaaaaaggaacagttagc


Gene-specific PCR Primers
Primer Name	Sequence
F_PCR_Amplicon_1	ctaataggggcgacactccg
F_PCR_Amplicon_2	CCGAGTAGCGTTGGGTTGCG
F_PCR_Amplicon_3	GATCTGGACGAAGAGCATCAGGG
F_PCR_Amplicon_4	atggctcccatcactgct
F_PCR_Amplicon_5	GTGCCTCTGCGGCCAAAAGCC
F_PCR_Amplicon_6	TGGCAGTGGAAAGAGCAC
F_PCR_Amplicon_7	TGGGCTTGAATGCCGTG
F_PCR_Amplicon_8	GGACGCCATGTGGAAGTG
F_PCR_Amplicon_9	GAACTTCATTAGCGGCATCC
F_PCR_Amplicon_10	GACTGCCCCATCCCATG
F_PCR_Amplicon_11	TGCAGATCCATAGGTTTGCA
F_PCR_Amplicon_12	CGCCGCTCGTGGAATC
F_PCR_Amplicon_13	TGCTCGACGCCCATTATG
F_PCR_Amplicon_14	CCGCACTGCCATACACTC
F_PCR_Amplicon_15	CATGGTCCAAGACACCCTG
R_PCR_Amplicon_1	ctttgaggtttaggatttgtgctc
R_PCR_Amplicon_2	GGCATCGCCATGGGTCACGACGAG
R_PCR_Amplicon_3	CTTCAGCCCCTTGTTGAATACGC
R_PCR_Amplicon_4	GCCGGGATGACATCAGCGTTCC
R_PCR_Amplicon_5	GTTGGGATTGATGCCATGTG
R_PCR_Amplicon_6	CATTGCAGTCGATCACGGA
R_PCR_Amplicon_7	GTGGCGATGTACTTCGTCC
R_PCR_Amplicon_8	GATGTTGAGAAGGATGGTGGT
R_PCR_Amplicon_9	GACAAGAGATGAAGGGGAGG
R_PCR_Amplicon_10	GGACCTCAATACGTCTGCG
R_PCR_Amplicon_11	TATGGTGCTCTCGCTCAGA
R_PCR_Amplicon_12	CCATACTTGGATCTTGCAGAATG
R_PCR_Amplicon_13	CACATAGCATGTGATGGTGTT
R_PCR_Amplicon_14	GTGTGCATAGAAAAGGCGTC
R_PCR_Amplicon_15	aaggaacagttagctatggagtg
